# . # # # # # # # # # # # # # # # # # # # # # # # # # # # # # 
# . . . . . . . # . . . . . . . . . . . # . . . . . . . . . #
# # # # # # # . # # # # # . # # # # # . # . # # # # # # # . #
# . . . . . # . . . . . # . # . . . . . # . . . # . # . . . #
# . # # # . # # # # # . # . # # # # # . # # # . # . # . # # #
# . . . # . . . . . # . # . . . . . # . . . . . # . . . . . #
# # # # # . # # # . # . # # # # # . # # # # # . # # # # # # #
# . . . . . # . . . # . . . . . # . # . . . . . # . . . . . #
# . # # # # # . # # # # # # # . # . # # # # # # # . # # # . #
# . . . # . # . # . . . . . # . # . . . . . . . . . # . . . #
# . # . # . # . # . # # # . # . # # # . # # # # # # # . # # #
# . # . # . . . # . # . . . # . . . # . . . . . . . # . . . #
# . # . # # # # # . # . # # # # # . # # # # # # # . # # # . #
# . # . . . . . . . # . # . . . # . # . . . . . . . . . # . #
# . # # # # # # # # # . # . # . # . # . # # # # # # # . # . #
# . # . . . # . . . # . . . # . # . # . . . # . . . # . # . #
# . # . # . # . # # # # # . # . # . # . # # # . # . # # # . #
# . . . # . . . # . . . # . # . # . # . # . . . # . . . . . #
# # # # # # # . # . # . # . # . # . # . # . # # # # # # # . #
# . . . . . # . # . # . # . # . # . # . # . # . . . . . # . #
# . # # # . # . # . # . # # # . # . # # # . # # # . # . # . #
# . # . . . # . # . # . . . . . # . . . # . . . # . # . # . #
# . # # # . # # # . # # # # # . # # # . # . # . # . # . # . #
# . . . # . . . . . # . . . . . . . # . # . # . # . # . . . #
# . # . # # # # # # # # # # # # # # # . # # # . # # # . # # #
# . # . # . . . . . # . . . . . . . # . . . # . . . # . # . #
# . # . # . # # # . # . # # # # # . # # # . # # # . # . # . #
# . # . . . # . # . . . # . . . # . . . # . # . . . # . . . #
# . # # # # # . # # # # # # # . # # # . # . # . # # # # # . #
# . . . . . . . . . . . . . . . . . # . . . . . # . . . . . #
# # # # # # # # # # # # # # # # # # # # # # # # # # # # # . #
